333333333333333333333
333333333333333333333
333333333333333333333
111111111111111111111
100000000010000000001
101110111010111011101
101110111010111011101
100000000000000000001
101110101111101011101
100000100010001000001
111110111010111011111
222210100000001012222
111110101131101011111
000000001333100000000
111110101333101011111
222210101111101012222
222210100000001012222
111110001111100011111
100000000010000000001
101110111010111011101
100010000000000010001
111010101111101010111
100000100010001000001
101111111010111111101
100000000000000000001
111111111111111111111
333333333333333333333
333333333333333333333
